######################################################################################################################################################
#....................................................................................................................................................#
#....................................................................................................................................................#
#....................................................................................................................................................#
#....................................................................................................................................................#
#....................................................................................................................................................#
#....................................................................................................................................................#
#....................................................................................................................................................#
#.....................##########.....................................................................................................................#
#.....................##########............................................................#######..................................................#
#..........................................................................................#######...................................................#
#....................................................................................................................................................#
#....................................................................................................................................................#
#....................................................................................................................................................#
#.................................................................................................P..................................................#
#....................................................................................................................................................#
#....................................................................................................................................................#
#....................................................................................................................................................#
#....................................................................................................................................................#
#....................................................................................................................................................#
#....................................................................................................................................................#
#....................................................................................................................................................#
#....................................................................................................................................................#
#....................................................................................................................................................#
#....................................................................................................................................................#
#....................................................................................................................................................#
##############################################################.@.....................................................................................#
#....................................................................................................................................................#
#....................................................................................................................................................#
#....................................................................................................................................................#
#....................................................................................................................................................#
#..............................................................................................###..#########........................................#
#..............................................................................................###..#########........................................#
#..............................................................................................###.....######........................................#
#..............................................................................................###......#####........................................#
#..............................................................................................##############........................................#
#....................................................................................................................................................#
#....................................................................................................................................................#
#....................................................................................................................................................#
#....................................................................................................................................................#
#....................................................................................................................................................#
#....................................................................................................................................................#
######################################################################################################################################################